WWWWWWWWWW
.........W
..WWWW...W
..W......W
..WWWWWWWW
.........W
.........W
..WWWWWWWW
.......WWW
.........W