WWWWWWWWWW
..W......W
..WW.....W
..W......W
..WW.....W
.........W
.........W
..WWW....W
..W......W
..W...WW.W