WWWWWWWWWW
..W......W
..WWWW...W
..W......W
..WWWW...W
.........W
.........W
..WWW....W
..W....WWW
..WWWWWW.W