WWWWWWWWWW
..W......W
..WWW....W
..W......W
..WWWWW..W
.........W
.........W
..WWW....W
..W......W
..W...WW.W