WWWWWWWWWW
.........W
..WWWWW..W
.........W
..WWWWW..W
.........W
.........W
.........W
.........W
.........W