WWW......W
W........W
W.....S..W
..S......W
.........W
.......WWW
..W......W
WWW..S...W
W........W
WWWWWWWWWW