..W......W
..W......W
..W......W
..WWWWW..W
.........W
..WW..WW.W
..W......W
WWWWWW...W
W........W
WWWWWWWWWW