.........W
.........W
...S.....W
.........W
.........W
.S.......W
.........W
......S..W
.........W
WWWWWWWWWW