.........W
.........W
.........W
..WWWWW..W
.........W
..WWWWWW.W
......S..W
..WWWWW..W
..S....S.W
WWWWWWWWWW