WWW......W
WS...WW..W
W....WW..W
.........W
......S..W
.........W
W..WW....W
W..WW....W
W.S......W
WWWWWWWWWW