.........W
.........W
.........W
..WWWWW..W
.........W
..WWWWWW.W
.........W
..WWWWW..W
.........W
WWWWWWWWWW