..W......W
..W...S..W
..W......W
..WWWWW..W
.........W
..WW..WW.W
..W.S....W
WWWWWW...W
W.......SW
WWWWWWWWWW