WWWWWWWWWW
..W......W
.........W
..........
..........
WWWWW.....
W.........
W.........
W.........
W.........