WWWWWWWWWW
..........
..........
..........
..........
..........
w.........
w.........
w.........
w.........