WWWWWWWWWW
..W...W...
..W...W...
..W.......
..WWWWW...
..........
w.........
w.........
w.........
w.........