WWWWWWWWWW
..W...W..W
..W...W..W
..W......W
..WWWWW..W
..........
...WWWWW..
.WW....WWW
.......WW.
...WWWWW..