WWWWWWWWWW
..W...W..W
..W...W..W
..W.......
..WWWWW...
..........
...WWWWW..
.WW....WWW
.......WW.
.......W..