W.....WWWW
W....WW...
..........
.WWWW.....
.W........
..........
....WWWWWW
WW..W.....
....W.....
WWWWWWWWWW