.....WWWWW
.....WW...
WWWWWWW...
..........
..........
..........
...WWwwWWW
wwwWW.....
..........
WWWWWWWWWW