W....WWWWW
W....WW...
..........
WWWWW.....
W.........
..........
....WwwWWW
ww..W.....
....W.....
WWWWWWWWWW