..........
.....WW...
.....WW...
..........
..........
..........
...WW.....
...WW.....
..........
WWWWWWWWWW