......WWWW
.....WW...
WWWWWWW...
..........
..........
..........
...WWWWWWW
WWWW.....
..........
WWWWWWWWWW