WWWWWWWWWW
W.........
WWWWWW....
W.........
W.........
WWWW...WW.
W........W
W........W
W..WW.W..W
W.........