WWWWWWWWWW
W.........
W....WWWWW
W....W....
W...WW....
W..WW.....
W.........
W...WW..WW
W...W.....
W...W.....