WWWWWWWWWW
W.........
WWWWWW....
W........W
W........W
WWWW...WWW
W........W
W........W
W..WW.W..W
W.........