WWWWWWWWWW
W.........
WW........
W...W.....
W....W....
WWW.WW....
W...W.....
W...W....W
W...WW...W
W.........