WWWWWWWWWW
W.........
WWWWWW....
W.........
W....W....
WWWWWW....
W.........
W.........
WWWW......
W.........