W.....WWWW
...W......
...WW.....
..........
..........
..W..W....
W.W..W....
..W..WWWWW
..W.......
WWW.......