..........
..........
...WWWW...
....WW....
...WWWW...
....WW....
.....W....
...WWWW...
..........
..........