...WWWWWWW
...W......
...WW.....
..........
..........
..W..W....
..W..W....
..W..WWWWW
WWW.......
..........