WWW...WWWW
...W......
.WWWWWW...
..W.......
..........
.....W....
W....W....
W....WWWWW
WW........
..........