..........
...W......
..WWWWWWWW
..........
..WWWWW...
....WW....
.....W....
...WWWWWWW
..........
..........