.........W
.........W
.........W
..W......W
...WWW...W
.........W
..W......W
..W......W
..wwwwwwwW
.........W