.........W
..W......W
..WW.....W
..W......W
.WWWW...WW
..WWW....W
..W......W
..W..WW..W
..W..WW..W
.........W