.........W
....WW...W
..WW..WW.W
..W......W
...WWW...W
...WW....W
..W..WW..W
..W......W
..WW.....W
.........W