.........W
.........W
..WWWWWW.W
..w......W
...WWW...W
.........W
..w......W
..w......W
..wwwwwwwW
.........W