.........W
..wW.....W
..WW.....W
WWwW.....W
........WW
.........W
WWw......W
..w......W
..w......W
..WWWW...W