WWW......W
..WW.....W
..WW.....W
.WWW.....W
........WW
.........W
WWW......W
..W......W
..WWW....W
..WWW....W