..wWWWW..W
..w......W
..WW.....W
..w......W
.WWWW...WW
.........W
..w......W
..w......W
..w......W
.........W