W.........
WWWWWW....
W.........
W.........
WWWWWW....
W.........
W.WWW....w
W...W....w
W...W....w
WWWWWWWWWW