W....WWWWW
WWW......W
W........W
W.....WWWW
W.........
WWW...W...
W.W...W..W
W........W
W...W....W
WWWWWWWWWW