W.......WW
W.........
W.WWWWWW..
W.W....W..
W.W.......
W.W.....W.
W.W.....W.
W.WWWWWWW.
W.....WW..
WWWWWWWWWW