W.....WWWW
WWWW.....W
W.......WW
W...WWWWW.
W.........
WWW...W...
W.W...W..W
W........W
W...W....W
WWWWWWWWWW