W..WWWWWWW
W..W.....W
W..W.....W
W..WWW..WW
W.........
W.........
W.WWW.....
W...W..W..
W...W..W..
WWWWWWWWWW