WWWWW.....
W.........
W......WWW
WWWW.....W
W........W
W..W.....W
WWWW...WWW
W.........
W...W....W
WWWWW...WW