WWW.......
W.........
W......WWW
WWWW......
W.....P...
W..W......
WWWW...WWW
W.........
W...W....W
WWW.....WW