WWWWW.....
W........W
W....W...W
W....W....
W....WWWWW
W....W...W
W....W...W
W....W....
W........W
W.......WW