WWW.......
W........W
W....W...W
W....W....
W....WWWW.
W....W....
W....W...W
W....W....
W........W
W.......WW