WWW.......
W.........
W.........
WWWW...WW.
W..W...W..
W.....WW..
WWW.......
W.......p.
W....W....
WWW...W...