WWWWW.....
W.........
W.........
WWWW...WWW
W..W...W..
W.....WW..
WWW.......
W.........
W....W....
WWWWWWW...