WWWWW.....
W.........
W...WWWWWW
W........W
W.WWWW...W
W........W
W...WWWWWW
W.........
W........W
WWWW....WW