WWW.......
W.........
W...WWWWWW
W.........
W.WWWW..P.
W.........
W...WWWWWW
W.........
W........W
WWW.....WW