WWW...W..W
.........W
WWWWWWW..W
..........
..........
.WWWWWW...
.........W
.........W
.........W
WWWWWWWWWW