..........
..........
..WWWWWW..
....W.....
....W...W.
....W...W.
........W.
..wwwwwwW.
.......W..
WWWWWWWWWW