WWWWWWWWWW
..W.......
.WWWWWWW..
.W..W.....
........W.
...WW...W.
....W...W.
WWWWWWWWW.
....W.....
WWWWWWWWWW